xxxxxxxxxx
x        x
xxxxxx x x
x        x
xxx x x xx
x x x x xx
x        x
x x xx x x
x x    x x
xxxxxxxxxx